1 : 1 : N
2 : 2 : D
3 : 3 : V
4 : 4 : K
5 : 5 : K
6 : 6 : Q
7 : 7 : Q
8 : 8 : Q
9 : 9 : M
10 : 10 : A
11 : 11 : A
12 : 12 : L
13 : 13 : T
14 : 14 : K
15 : 15 : E
16 : 16 : K
17 : 17 : D
18 : 18 : E
19 : 19 : L
20 : 20 : S
21 : 21 : K
22 : 22 : S
23 : 23 : I
24 : 24 : T
25 : 25 : M
26 : 26 : Y
27 : 27 : R
28 : 28 : S
29 : 29 : L
30 : 30 : F
31 : 31 : D
32 : 32 : A
33 : 33 : N
34 : 34 : K
35 : 35 : Q
36 : 36 : L
37 : 37 : V
38 : 38 : D
39 : 39 : E
40 : 40 : M
41 : 41 : K
42 : 42 : C
43 : 43 : Q
44 : 44 : A
45 : 45 : E
46 : 46 : E
47 : 47 : A
48 : 48 : K
49 : 49 : L
50 : 50 : K
51 : 51 : E
52 : 52 : T
53 : 53 : Q
54 : 54 : L
55 : 55 : R
56 : 56 : N
57 : 57 : E
58 : 58 : L
59 : 59 : K
60 : 60 : A
61 : 61 : Y
62 : 62 : N
63 : 63 : I
64 : 64 : D
65 : 65 : I
66 : 66 : P
67 : 67 : A
68 : 68 : T
69 : 69 : Q
70 : 70 : Q
71 : 71 : T
72 : 72 : T
73 : 73 : H
74 : 74 : I
75 : 75 : E
76 : 76 : A
77 : 77 : L
78 : 78 : L
79 : 79 : E
80 : 80 : K
81 : 81 : K
82 : 82 : I
83 : 83 : T
84 : 84 : E
85 : 85 : Q
86 : 86 : N
87 : 87 : E
88 : 88 : L
89 : 89 : K
90 : 90 : K
91 : 91 : R
92 : 92 : P
93 : 93 : R
94 : 94 : R
95 : 95 : L
96 : 96 : C
97 : 97 : T
98 : 98 : L
99 : 99 : P
100 : 100 : N
101 : 101 : Y
102 : 102 : T
103 : 103 : K
104 : 104 : R
105 : 105 : S
106 : 106 : G
107 : 107 : D
108 : 108 : I
109 : 109 : L
110 : 110 : G
111 : 111 : K
112 : 112 : I
113 : 113 : A
114 : 114 : H
115 : 115 : L
116 : 116 : A
117 : 117 : Q
118 : 118 : I
119 : 119 : E
120 : 120 : D
121 : 121 : D
122 : 122 : R
123 : 123 : A
124 : 124 : A
125 : 125 : M
126 : 126 : V
127 : 127 : I
128 : 128 : S
129 : 129 : W
130 : 130 : H
131 : 131 : L
132 : 132 : A
133 : 133 : S
134 : 134 : D
135 : 135 : M
136 : 136 : D
137 : 137 : C
138 : 138 : V
139 : 139 : V
140 : 140 : T
141 : 141 : L
142 : 142 : T
143 : 143 : T
144 : 144 : D
145 : 145 : A
146 : 146 : A
147 : 147 : R
148 : 148 : A
149 : 149 : I
150 : 150 : Y
151 : 151 : D
152 : 152 : E
153 : 153 : T
154 : 154 : Q
155 : 155 : G
156 : 156 : R
157 : 157 : Q
158 : 158 : Q
159 : 159 : V
160 : 160 : L
161 : 161 : P
162 : 162 : L
163 : 163 : D
164 : 164 : S
165 : 165 : I
166 : 166 : Y
167 : 167 : R
168 : 168 : K
169 : 169 : T
170 : 170 : L
171 : 171 : P
172 : 172 : D
173 : 173 : W
174 : 174 : K
175 : 175 : R
176 : 176 : P
177 : 177 : L
178 : 178 : P
179 : 179 : H
180 : 180 : F
181 : 181 : R
182 : 182 : N
183 : 183 : G
184 : 184 : K
185 : 185 : L
186 : 186 : H
187 : 187 : F
188 : 188 : K
189 : 189 : P
190 : 190 : F
191 : 191 : G
192 : 192 : N
193 : 193 : P
194 : 194 : V
195 : 195 : F
196 : 196 : A
197 : 197 : R
198 : 198 : D
199 : 199 : L
200 : 200 : L
201 : 201 : T
202 : 202 : F
203 : 203 : P
204 : 204 : D
205 : 205 : N
206 : 206 : I
207 : 207 : E
208 : 208 : H
209 : 209 : C
210 : 210 : E
211 : 211 : T
212 : 212 : V
213 : 213 : F
214 : 214 : G
215 : 215 : M
216 : 216 : L
217 : 217 : L
218 : 218 : G
219 : 219 : D
220 : 220 : T
221 : 221 : I
222 : 222 : I
223 : 223 : L
224 : 224 : D
225 : 225 : N
226 : 226 : L
227 : 227 : D
228 : 228 : A
229 : 229 : A
230 : 230 : N
231 : 231 : H
232 : 232 : Y
233 : 233 : R
234 : 234 : K
235 : 235 : E
236 : 236 : V
237 : 237 : V
238 : 238 : K
239 : 239 : I
240 : 240 : T
241 : 241 : H
242 : 242 : C
243 : 243 : P
244 : 244 : T
245 : 245 : L
246 : 246 : L
247 : 247 : T
248 : 248 : R
249 : 249 : D
250 : 250 : G
251 : 251 : D
252 : 252 : R
253 : 253 : I
254 : 254 : R
255 : 255 : S
256 : 256 : N
257 : 257 : G
258 : 258 : K
259 : 259 : F
260 : 260 : G
261 : 261 : G
262 : 262 : L
263 : 263 : Q
264 : 264 : N
265 : 265 : K
266 : 266 : A
267 : 267 : P
268 : 268 : P
269 : 269 : M
270 : 270 : D
271 : 271 : K
272 : 272 : L
273 : 273 : R
274 : 274 : G
275 : 275 : M
276 : 276 : V
277 : 277 : F
278 : 278 : G
279 : 279 : A
280 : 280 : P
281 : 281 : V
282 : 282 : P
283 : 283 : K
284 : 284 : Q
